1of1
for idx in df.index:

            BBD=df.at[idx, "BB textfield"]

            FCD=df.at[idx, "FCD textfield"]

            FTY=BBD

            FTX=np.sqrt(FTY**2+FCD**2)

            x=df.at[idx, "FORK0R"]

            fkl=df.at[idx, "FORK0L"]

            htlx=df.at[idx, "Head tube lower extension2"]

            lsth=df.at[idx, "Lower stack height"]

            y=fkl+htlx+lsth

            ha=df.at[idx, "Head angle"]*np.pi/180

            dtx=FTX-y*np.cos(ha)-x*np.sin(ha)

            dty=FTY+y*np.sin(ha)+x*np.cos(ha)

            df.at[idx, "DT Length"]=np.sqrt(dtx**2+dty**2)



            csbd=df.at[idx, "Chain stay back diameter"]

            csvd=df.at[idx, "Chain stay vertical diameter"]

            csd=(csbd+csvd)/2

            df.at[idx, "csd"]=csd



            ssbd=df.at[idx, "Seat stay bottom diameter"]

            sshr=df.at[idx, "SEATSTAY_HR"]

            ssd=(ssbd+sshr)/2

            df.at[idx, "ssd"]=ssd



            ttrd=df.at[idx, "Top tube rear diameter"]

            ttrd2=df.at[idx, "Top tube rear dia2"]

            ttfd=df.at[idx, "Top tube front diameter"]

            ttfd2=df.at[idx, "Top tube front dia2"]

            ttd=(ttrd+ttrd2+ttfd+ttfd2)/4

            df.at[idx, "ttd"]=ttd



            dtrd=df.at[idx, "Down tube rear diameter"]

            dtrd2=df.at[idx, "Down tube rear dia2"]

            dtfd=df.at[idx, "Down tube front diameter"]

            dtfd2=df.at[idx, "Down tube front dia2"]

            dtd=(dtrd+dtrd2+dtfd+dtfd2)/4

            df.at[idx, "dtd"]=dtd





            df.at[idx, "Wall thickness Bottom Bracket"]=2.0

            df.at[idx, "Wall thickness Head tube"]=1.1

        print(df.head)

        return df